NO ./texture/nord.png
SO ./texture/sud.png
WE ./texture/ouest.png
EA ./texture/est.png
F 50,100,0
C 225,30,0







        1111111111111111111111111
        1000000000110000000000001
        10110N0000110000000000001
        1001000000000000000000001
111111111001000001110000000000001
100000000000000001110000100011111
11000100000000011100000010001
11000111111100011101010010001
11000000110000011100000010001
10000000000000001100000010001
10000000000000001101010010001
10000000000000000000000000001
10000000000000000000000000001
10000000000000000000000000001
10000000000000000000000000001
11000001110000011100001110001
10000001 1000001 100001010001
10000001 1000001 100001110001
10000001110000011100000000001
10000000000000000000000000001
10000000000000000000000000001
11111111111111111111111111111
