NO ./texture/nord.png
SO	./texture/sud.png 
 
EA	./textures/est.png 	
F 220,150,186,45

C 225,100,0






WE ./texture/ouest.png 


        1111111111111111111111111
 N      1000000000110000000000001
        10110000001110000000000001
        1001000000000000000000001
111111111011000001110000000000001
100000000011000001110111111111111
11110111111111011100000010001
11110111111111011101010010001
11111111 1111111 11101111111
  
1111111111111111111111111

11111111 1111111 11111111111



